###################
###################
###################
###################
###################
###OO..#.....######
###OO..#.X..X..####
###OO..#X####..####
###OO....@.##..####
###OO..#.#..X.#####
########.##X.X.####
#####.X..X.X.X.####
#####....#.....####
###################
###################
###################
###################
