###################
############..OOOO#
############..OOOO#
#....#..X.X...OOOO#
#.XXX#X..X.#..OOOO#
#..X.....X.#..OOOO#
#.XX.#X.X.X########
#..X.#.....########
##.################
#....#....#########
#.....X...#########
#..XX#XX..@########
#....#....#########
###################
###################
###################
###################
