###################
###########...#####
###########.#X##..#
###########.....X.#
###########.###...#
###OOOO..##.X..X###
###OOOO....X.XX.###
###OOOO..##X..X.@##
###########..X..###
###########.X.X..##
#############.##.##
#############....##
###################
###################
###################
###################
###################
