###################
########OO..####@##
########OO..###...#
########OO.....XX.#
########OO..#.#.X.#
########OO###.#.X.#
###########.X.#X..#
###########..X#.X.#
###########.X..X..#
###########..##...#
###################
###################
###################
###################
###################
###################
###################
